NO textures/north.xpm
SO textures/north.xpm
WE textures/plastic.xpm
EA textures/plastic.xpm

F 255,0,0
C 0,0,255


        111111
        100001
  111111100001
11100000000001
10100111100001
101001  100001
101001  100001
101001  111111
100001
1100N1
1 1111
 