NO textures/box.xpm
SO textures/box.xpm
WE textures/box.xpm
EEA ./textures/greystone.xpm
 
F 255,125,0
C 0,125,255

1111
10N1
1111